2 2 2 2 2 2 2 2 2 2 2 2 2 
2 3 0 0 0 0 1 0 0 1 0 0 2
2 0 2 7 2 0 2 1 2 0 2 9 2
2 1 0 0 0 0 0 0 1 0 0 1 2
2 0 2 0 2 0 2 0 2 0 2 0 2 
2 0 1 0 0 0 1 0 0 0 1 0 2 
2 0 2 0 2 0 2 0 2 0 2 0 2 
2 1 0 1 1 0 0 0 1 0 0 0 2 
2 0 2 0 2 0 2 4 2 0 2 1 2
2 1 0 0 0 1 0 0 0 1 1 0 2
2 0 2 0 2 0 2 0 2 0 2 0 2 
2 1 0 8 0 1 0 1 0 8 0 4 2
2 2 2 2 2 2 2 2 2 2 2 2 2