2 2 2 2 2 2 2 2 2 2 2 2 2
2 3 0 0 1 0 0 0 0 0 0 0 2
2 0 2 1 2 0 2 1 2 0 2 0 2
2 0 0 0 0 0 0 0 1 0 0 8 2
2 0 2 0 2 0 2 0 2 0 2 0 2
2 0 0 1 0 0 1 0 0 0 1 0 2
2 0 2 0 2 0 2 0 2 0 2 0 2
2 0 0 1 1 0 0 0 1 0 0 0 2
2 0 2 0 2 0 2 0 2 0 2 0 2
2 1 0 0 0 1 0 0 0 9 1 0 2
2 0 2 0 2 0 2 0 2 0 2 0 2
2 0 0 0 0 7 0 0 0 0 1 0 2
2 2 2 2 2 2 2 2 2 2 2 2 2