2 2 2 2 2 2 2 2 2 2 2 2 2 
2 3 0 0 0 1 1 0 0 4 0 0 2
2 2 2 4 2 1 2 1 2 0 2 7 2
2 9 2 0 2 0 0 0 1 0 0 1 2
2 0 2 2 2 0 2 0 2 0 2 0 2 
2 0 1 0 0 0 1 0 0 0 1 0 2 
2 0 2 0 2 0 2 0 2 0 2 0 2 
2 1 0 1 1 0 0 0 1 0 0 0 2 
2 0 2 0 2 4 2 1 2 0 2 1 2
2 0 0 1 0 1 0 0 0 1 0 0 2
2 0 2 0 2 0 2 0 2 0 2 0 2 
2 8 0 1 0 1 0 1 0 7 0 1 2
2 2 2 2 2 2 2 2 2 2 2 2 2